00000000000000000001000001000000000000
00000000000100000001000001000000000000
00000000000100000001000001000000000000
00000000000100000001000001000000000000
00000000000100000001000001000000000000
00000000000101110001000001000000000000
10000000011100000000000001000000000000
10000010000100000000000000000000000000
11111111111111111111111111111111111111
11111111111111111111111111111111111111
11111111111111111111111111111111111111
11111111111111111111111111111111111111
11111111111111111111111111111111111111